1 1 0 0 0 0 0 0 0 3 0 0 0 0 0 0
1 1 6 6 6 6 6 6 6 3 2 0 0 0 0 0
1 1 0 0 0 0 0 0 0 3 2 0 0 0 0 0
1 1 0 0 0 0 0 0 0 3 2 2 2 0 0 0
1 1 0 0 0 0 0 0 0 0 3 2 2 0 0 0
1 1 0 0 0 0 0 0 0 0 3 2 2 0 0 0
1 1 0 0 0 0 0 0 5 4 3 2 2 0 0 0
1 1 0 0 0 0 0 0 4 4 3 3 3 3 3 3
0 0 0 0 0 0 0 0 5 5 3 3 3 3 3 3
0 0 0 0 0 0 0 0 5 5 2 2 2 2 2 2
0 0 0 0 0 0 0 0 4 4 0 0 0 0 0 0
0 0 0 0 0 0 0 0 4 4 0 0 0 0 0 0